##############
#....#...#|-|#
#.S..#...##-##
#....|.....@k#
##############