##############
#....#.......#
#.S..#...@...#
#....|......k#
##############