#######
#..#|-|
#k.##.#
#..##.#
#.....#
#.....#
#######