########
#..#|-|#
#k.##.##
#..##.##
#.....##
#.....##
