###############
#....#....#|-|#
#....#....##-##
#....|.........
###############