##############
#....#...#|-|#
#.S..#...##-##
#....|k.....k.
##############