##############
#....#...#|-|#
#....#...##-##
#....|k.....k.
##############