###############
#....#....#|-|#
#....#....##-##
#....|k......k.
###############