##############
#....#...#|-|#
#.S..#...##-##
#....|k.....k#
##############