##############
#....#...#|-|#
#.S..#...##-##
#....|......k#
##############