#################
#.......#.......#
#.......#.#####.#
#.........#.....#
###############.#
#.....#.....#...#
#.....#..#..#...#
#........#......#
#################

